SO ./textures/king.xpm
NO ./textures/king.xpm
WE ./textures/king.xpm
EA ./textures/king.xpm

F 29,48,47
C 4,218,219

1111111111111111111111111111111111111111
1000000000000000000000000000000000000001
1000000000000000000000000000000000000001
10000000000000000000000E0000000000000001
1000000000000000000000000000000000000001
1000000010100000000000000000000000100101
1000000000000000000000000000000000000001
1010001010000000000000000000000010100101
1010101011111111111111111111111010100101
1010101000000000000000000000000010100101
1010101111111111111111111111111010100101
1010100000000000000000000000000010100101
1010111111111111111111111111111110100101
1000000000000000000000000000000000100001
1111111111111111111111111111111111111111
